18 16
 104  115  115  115  115  115  115  115  115  115  115  115  115  115  115  93 
 117  12  0  80  0  0  0  0  0  0  0  7  19  0  12  114 
 117  0  0  0  48  0  0  48  0  0  0  8  20  0  0  114 
 117  12  0  0  0  0  0  0  34  46  0  9  21  80  0  114 
 92  116  116  116  116  116  116  116  116  140  0  0  0  0  0  114 
 115  115  115  115  115  115  115  115  93  117  32  44  0  0  0  114 
 0  0  0  7  19  0  0  12  129  141  33  45  0  0  12  129 
 0  12  0  8  20  0  0  0  94  81  0  0  3  15  0  81 
 56  68  0  9  10  22  0  0  94  81  0  0  4  16  0  81 
 57  69  0  0  11  23  74  0  94  81  0  0  5  17  0  81 
 0  12  0  0  0  63  75  0  94  81  0  0  6  18  0  81 
 34  46  0  0  0  64  76  12  128  140  32  44  0  0  12  128 
 116  116  116  116  116  116  116  116  105  117  33  45  0  0  0  114 
 104  115  115  115  115  115  115  115  115  141  0  0  0  0  80  114 
 117  12  0  80  0  0  0  0  0  0  0  62  74  0  0  114 
 117  0  0  0  48  0  0  48  0  0  0  63  75  34  46  114 
 117  12  0  0  0  0  0  80  0  0  0  64  76  0  12  114 
 92  116  116  116  116  116  116  116  116  116  116  116  116  116  116  105 