18 16
 112  112  112  104  115  115  115  115  115  115  115  115  115  115  115  93 
 112  112  112  117  24  36  48  0  12  0  0  12  7  19  12  114 
 112  112  112  117  25  37  49  48  0  0  0  80  8  20  0  114 
 112  112  112  117  0  0  0  0  0  0  106  0  9  21  0  114 
 112  112  112  117  0  0  0  128  116  140  0  80  0  0  0  114 
 104  115  115  141  0  0  0  129  93  117  0  0  0  0  0  114 
 117  0  0  0  10  22  0  12  114  117  0  0  0  0  12  129 
 117  0  0  0  11  23  0  0  114  117  80  0  3  15  0  81 
 117  60  72  84  96  0  0  0  114  117  0  0  4  16  0  81 
 117  61  73  85  97  0  0  0  114  117  0  0  5  17  0  81 
 117  0  0  0  10  22  0  0  114  117  0  0  6  18  0  81 
 117  0  0  0  11  23  80  12  114  117  80  0  0  106  12  128 
 92  116  116  140  0  0  0  128  105  92  116  116  140  0  0  114 
 112  112  112  117  0  0  80  129  115  115  115  115  141  0  0  114 
 112  112  112  117  34  46  106  60  72  84  96  62  0  62  74  114 
 112  112  112  117  0  0  0  61  73  85  97  0  0  63  75  114 
 112  112  112  117  12  0  0  0  12  0  106  12  80  64  76  114 
 112  112  112  92  116  116  116  116  116  116  116  116  116  116  116  105 