18 16
 112  112  112  112  112  112  112  112  112  112  112  112  112  112  112  112 
 112  112  112  112  112  112  112  112  112  112  112  112  112  112  112  112 
 112  112  112  112  112  112  112  104  115  115  115  93  112  112  112  112 
 112  112  112  112  112  112  112  117  0  0  0  129  115  115  115  93 
 112  112  112  112  112  112  112  117  0  0  106  113  26  38  50  114 
 112  112  112  104  115  115  115  141  71  71  71  113  106  39  51  114 
 112  112  112  117  12  7  19  12  0  0  0  12  0  0  0  129 
 112  112  112  117  0  8  20  10  22  60  72  84  96  0  0  82 
 112  112  112  117  106  9  21  11  23  61  73  85  97  10  22  82 
 112  112  112  117  106  3  15  0  0  0  0  0  0  11  23  82 
 112  112  112  117  12  4  16  12  128  116  140  0  0  0  0  82 
 112  112  112  117  0  5  17  106  114  112  117  12  10  22  12  128 
 112  112  112  117  0  6  18  0  114  112  117  124  11  23  124  114 
 112  112  112  117  12  10  22  12  114  112  117  106  0  0  106  114 
 112  112  112  117  0  11  23  0  114  112  117  12  89  101  12  114 
 112  112  112  117  0  107  107  0  114  112  117  106  90  102  106  114 
 112  112  112  117  12  107  107  12  114  112  117  12  91  103  12  114 
 112  112  112  92  116  116  116  116  105  112  92  116  116  116  116  105 