18 16
 0  0  0  0  48  0  0  0  0  0  0  0  0  0  0  0 
 0  0  0  0  0  0  0  0  0  0  0  0  0  0  0  0 
 0  0  0  0  0  0  0  0  0  0  0  0  0  0  0  0 
 0  0  0  0  0  0  0  0  0  0  0  0  0  0  0  0 
 116  116  116  116  116  116  116  116  116  140  0  0  0  0  0  0 
 115  115  115  115  115  115  115  115  93  117  0  0  0  0  0  0 
 0  0  0  7  19  0  0  0  129  141  0  0  0  0  0  0 
 0  12  0  8  20  0  0  0  94  81  0  0  0  0  0  0 
 56  68  0  9  21  0  0  0  94  81  0  0  0  0  0  0 
 57  69  0  0  0  62  74  0  94  81  0  0  0  0  0  0 
 0  12  0  0  0  63  75  0  94  81  0  0  0  0  0  0 
 0  0  0  0  0  64  76  0  114  117  0  0  0  0  0  0 
 116  116  116  116  116  116  116  116  105  117  0  0  0  0  0  0 
 115  115  115  115  115  115  115  115  115  141  0  0  0  0  0  0 
 0  0  0  0  0  0  0  0  0  0  0  0  0  0  0  0 
 0  0  0  0  0  0  0  0  0  0  0  0  0  0  0  0 
 0  0  0  0  0  0  0  0  0  0  0  0  0  0  0  0 
 0  0  0  0  0  0  0  0  0  0  0  0  0  0  0  0 