18 16
 112  112  112  112  112  112  112  112  112  112  112  112  112  112  112  112 
 112  112  112  112  112  112  112  112  112  112  112  112  112  112  112  112 
 112  112  112  112  112  112  112  112  112  112  112  112  112  112  112  112 
 112  112  104  115  115  115  115  115  115  115  115  115  115  93  112  112 
 112  112  117  7  19  0  0  0  34  46  0  0  0  114  112  112 
 112  112  117  8  20  0  0  0  0  0  0  0  0  114  112  112 
 112  112  117  9  106  0  0  0  0  0  0  0  0  114  112  112 
 112  112  117  0  0  0  12  124  124  124  124  124  124  114  112  112 
 112  112  117  0  0  0  113  65  77  0  0  0  106  114  112  112 
 112  112  117  0  0  0  113  66  78  0  0  0  0  114  112  112 
 112  112  117  0  34  46  113  67  79  0  0  0  0  114  112  112 
 112  112  117  0  0  0  12  124  124  124  12  0  0  114  112  112 
 112  112  117  0  106  0  0  0  106  0  0  0  0  114  112  112 
 112  112  117  24  36  48  0  0  0  0  0  0  0  114  112  112 
 112  112  117  25  37  49  0  0  0  0  0  0  106  114  112  112 
 112  112  92  116  116  116  116  116  116  116  116  116  116  105  112  112 
 112  112  112  112  112  112  112  112  112  112  112  112  112  112  112  112 
 112  112  112  112  112  112  112  112  112  112  112  112  112  112  112  112 