18 16
 112  112  112  112  112  112  112  112  112  112  112  112  112  112  112  112 
 112  104  115  115  115  115  115  115  115  115  93  112  112  112  112  112 
 112  117  12  0  0  0  0  106  0  12  114  112  112  112  112  112 
 112  117  0  0  0  0  0  0  0  0  114  112  112  112  112  112 
 112  117  0  0  0  106  0  0  0  12  114  112  112  112  112  112 
 112  117  0  0  12  128  116  116  116  116  105  112  112  112  112  112 
 112  117  106  0  0  114  112  112  112  112  112  112  112  112  112  112 
 112  117  124  83  83  129  115  115  115  93  104  115  115  115  93  112 
 112  117  0  0  0  80  0  86  98  114  117  12  107  107  114  112 
 112  117  80  0  0  0  0  87  99  114  117  106  107  107  114  112 
 112  117  0  0  106  0  80  88  100  114  117  0  0  0  114  112 
 112  117  0  0  0  128  116  116  116  105  117  0  0  0  114  112 
 112  117  0  0  0  114  112  112  112  112  117  0  0  106  114  112 
 112  117  0  0  0  129  115  115  115  115  141  12  0  12  114  112 
 112  117  0  10  22  0  106  0  0  0  0  0  62  74  114  112 
 112  117  0  11  23  0  0  0  0  0  0  0  63  75  114  112 
 112  117  106  0  0  12  0  0  0  106  0  0  64  76  114  112 
 112  92  116  116  116  116  116  116  116  116  116  116  116  116  105  112 