18 16
 112  112  34  46  112  112  112  112  112  112  112  112  112  112  112  112 
 112  112  34  46  112  112  112  112  0  0  112  112  112  112  112  112 
 112  112  34  46  112  89  101  112  112  112  112  112  0  112  0  112 
 112  112  112  112  112  90  102  112  0  0  112  112  112  112  112  112 
 112  112  112  112  112  91  103  112  112  0  0  112  112  0  112  112 
 112  112  112  112  112  112  112  112  0  112  112  0  112  112  112  112 
 112  112  112  112  112  112  112  0  112  112  0  0  112  112  112  112 
 112  112  0  112  0  0  112  112  112  112  112  112  112  0  112  112 
 112  112  112  112  112  112  0  112  0  112  112  0  112  112  112  112 
 112  112  0  112  112  112  112  112  112  0  112  0  112  112  0  112 
 112  112  112  112  112  112  0  112  112  0  112  112  0  112  112  112 
 112  112  112  0  112  112  112  112  112  112  112  0  112  112  112  0 
 112  112  112  112  112  112  112  0  112  0  112  112  112  112  0  112 
 112  112  112  112  112  0  0  112  112  112  112  112  0  112  112  112 
 112  112  112  112  112  0  112  112  112  112  0  0  112  112  112  112 
 112  112  112  112  112  0  112  112  0  112  112  112  112  112  0  112 
 112  112  112  112  112  112  112  112  0  112  112  112  0  112  112  112 
 112  112  112  112  112  112  112  112  112  112  112  112  112  112  112  112 